"filename", "language", "JavaScript JSX", "JavaScript", "Properties", "comment", "blank", "total"
"c:\Users\21H1 HNQA\Documents\mern_web\restaurants\client\src\Components\Admin\DataTable\DataTable.jsx", "JavaScript JSX", -3, 0, 0, -1, -1, -5
"c:\Users\21H1 HNQA\Documents\mern_web\restaurants\client\src\Components\Admin\ListItem\ListItem.jsx", "JavaScript JSX", -9, 0, 0, 0, 0, -9
"c:\Users\21H1 HNQA\Documents\mern_web\restaurants\client\src\Components\Admin\detailInfo\DetailCardAvatar.jsx", "JavaScript JSX", -2, 0, 0, -12, 0, -14
"c:\Users\21H1 HNQA\Documents\mern_web\restaurants\client\src\Components\Admin\detailInfo\DetailCardInfo.jsx", "JavaScript JSX", -4, 0, 0, 1, -1, -4
"c:\Users\21H1 HNQA\Documents\mern_web\restaurants\client\src\Components\FormDialog\FormDialogAddProduct.jsx", "JavaScript JSX", 63, 0, 0, 5, 9, 77
"c:\Users\21H1 HNQA\Documents\mern_web\restaurants\client\src\Components\User\logo\Logo.jsx", "JavaScript JSX", -18, 0, 0, 0, 0, -18
"c:\Users\21H1 HNQA\Documents\mern_web\restaurants\client\src\Contexts\CategoryContext.jsx", "JavaScript JSX", 14, 0, 0, 4, 1, 19
"c:\Users\21H1 HNQA\Documents\mern_web\restaurants\client\src\Contexts\OrderContext.jsx", "JavaScript JSX", 25, 0, 0, 0, 1, 26
"c:\Users\21H1 HNQA\Documents\mern_web\restaurants\client\src\Pages\Admin\Auth\AdminLogin\AdminLogin.jsx", "JavaScript JSX", -1, 0, 0, 6, 0, 5
"c:\Users\21H1 HNQA\Documents\mern_web\restaurants\client\src\Pages\Admin\CategoryManage\CategoryDetail.jsx", "JavaScript JSX", 152, 0, 0, 6, 18, 176
"c:\Users\21H1 HNQA\Documents\mern_web\restaurants\client\src\Pages\Admin\CategoryManage\CategoryManage.jsx", "JavaScript JSX", 30, 0, 0, 6, 3, 39
"c:\Users\21H1 HNQA\Documents\mern_web\restaurants\client\src\Pages\Admin\CategoryManage\index.jsx", "JavaScript JSX", 1, 0, 0, 0, 0, 1
"c:\Users\21H1 HNQA\Documents\mern_web\restaurants\client\src\Pages\Admin\Charts\Charts.jsx", "JavaScript JSX", -6, 0, 0, 0, -2, -8
"c:\Users\21H1 HNQA\Documents\mern_web\restaurants\client\src\Pages\Admin\Charts\index.jsx", "JavaScript JSX", -1, 0, 0, 0, 0, -1
"c:\Users\21H1 HNQA\Documents\mern_web\restaurants\client\src\Pages\Admin\CustomerManage\CustomerDetail.jsx", "JavaScript JSX", 75, 0, 0, 2, 3, 80
"c:\Users\21H1 HNQA\Documents\mern_web\restaurants\client\src\Pages\Admin\CustomerManage\CustomerManage.jsx", "JavaScript JSX", 17, 0, 0, -1, 0, 16
"c:\Users\21H1 HNQA\Documents\mern_web\restaurants\client\src\Pages\Admin\EmployeeManage\EmployeeDetail.jsx", "JavaScript JSX", 130, 0, 0, 6, 8, 144
"c:\Users\21H1 HNQA\Documents\mern_web\restaurants\client\src\Pages\Admin\EmployeeManage\EmployeeManage.jsx", "JavaScript JSX", 23, 0, 0, -1, 1, 23
"c:\Users\21H1 HNQA\Documents\mern_web\restaurants\client\src\Pages\Admin\EmployeeManage\index.jsx", "JavaScript JSX", 1, 0, 0, 0, 1, 2
"c:\Users\21H1 HNQA\Documents\mern_web\restaurants\client\src\Pages\Admin\OrderManage\OrderDetail.jsx", "JavaScript JSX", 82, 0, 0, 5, 8, 95
"c:\Users\21H1 HNQA\Documents\mern_web\restaurants\client\src\Pages\Admin\OrderManage\OrderManage.jsx", "JavaScript JSX", -9, 0, 0, -37, -7, -53
"c:\Users\21H1 HNQA\Documents\mern_web\restaurants\client\src\Pages\Admin\OrderManage\index.jsx", "JavaScript JSX", 1, 0, 0, 0, 1, 2
"c:\Users\21H1 HNQA\Documents\mern_web\restaurants\client\src\Pages\Admin\ProductManage\ProductManage.jsx", "JavaScript JSX", 6, 0, 0, 0, 1, 7
"c:\Users\21H1 HNQA\Documents\mern_web\restaurants\client\src\Pages\Admin\Profile\Profile.jsx", "JavaScript JSX", 26, 0, 0, 3, 3, 32
"c:\Users\21H1 HNQA\Documents\mern_web\restaurants\client\src\Pages\Admin\Profile\index.jsx", "JavaScript JSX", 1, 0, 0, 0, 0, 1
"c:\Users\21H1 HNQA\Documents\mern_web\restaurants\client\src\Pages\Admin\Setting\Setting.jsx", "JavaScript JSX", 31, 0, 0, 3, 3, 37
"c:\Users\21H1 HNQA\Documents\mern_web\restaurants\client\src\Pages\Admin\Setting\index.jsx", "JavaScript JSX", 1, 0, 0, 0, 1, 2
"c:\Users\21H1 HNQA\Documents\mern_web\restaurants\client\src\Pages\User\Auth\Login\Login.jsx", "JavaScript JSX", 8, 0, 0, 8, 1, 17
"c:\Users\21H1 HNQA\Documents\mern_web\restaurants\client\src\Pages\User\Auth\Register\Register.jsx", "JavaScript JSX", -7, 0, 0, 9, -2, 0
"c:\Users\21H1 HNQA\Documents\mern_web\restaurants\client\src\Pages\User\OrderPage\OrderPageDetail.jsx", "JavaScript JSX", 19, 0, 0, 1, 5, 25
"c:\Users\21H1 HNQA\Documents\mern_web\restaurants\client\src\Pages\User\SettingPage\SettingPage.jsx", "JavaScript JSX", 31, 0, 0, 3, 3, 37
"c:\Users\21H1 HNQA\Documents\mern_web\restaurants\client\src\Pages\User\SettingPage\index.jsx", "JavaScript JSX", 1, 0, 0, 0, 0, 1
"c:\Users\21H1 HNQA\Documents\mern_web\restaurants\client\src\Reducers\OrderReducer\action.jsx", "JavaScript JSX", 7, 0, 0, 0, 1, 8
"c:\Users\21H1 HNQA\Documents\mern_web\restaurants\client\src\Reducers\OrderReducer\constant.jsx", "JavaScript JSX", 1, 0, 0, 0, 0, 1
"c:\Users\21H1 HNQA\Documents\mern_web\restaurants\client\src\Reducers\OrderReducer\reducer.jsx", "JavaScript JSX", 6, 0, 0, 0, 0, 6
"c:\Users\21H1 HNQA\Documents\mern_web\restaurants\client\src\Service\categoryApi.jsx", "JavaScript JSX", 4, 0, 0, 0, 0, 4
"c:\Users\21H1 HNQA\Documents\mern_web\restaurants\client\src\Service\orderApi.jsx", "JavaScript JSX", 4, 0, 0, 0, 0, 4
"c:\Users\21H1 HNQA\Documents\mern_web\restaurants\client\src\layouts\admin\DashboardLayoutAdmin.jsx", "JavaScript JSX", 2, 0, 0, 0, 0, 2
"c:\Users\21H1 HNQA\Documents\mern_web\restaurants\client\src\layouts\dashboard\header\AccountPopover.jsx", "JavaScript JSX", 2, 0, 0, 0, 0, 2
"c:\Users\21H1 HNQA\Documents\mern_web\restaurants\client\src\routers\routes.jsx", "JavaScript JSX", 9, 0, 0, 0, 0, 9
"c:\Users\21H1 HNQA\Documents\mern_web\restaurants\client\src\section\@dashboard\cart\CartConfirm\CartConfirm.jsx", "JavaScript JSX", 0, 0, 0, 1, -2, -1
"c:\Users\21H1 HNQA\Documents\mern_web\restaurants\client\src\section\@dashboard\cart\CartConfirm\CartConfirmProductItem.jsx", "JavaScript JSX", -1, 0, 0, 0, -1, -2
"c:\Users\21H1 HNQA\Documents\mern_web\restaurants\client\src\section\@dashboard\cart\CartPayment\CartShipInfo.jsx", "JavaScript JSX", 1, 0, 0, 0, 0, 1
"c:\Users\21H1 HNQA\Documents\mern_web\restaurants\client\src\section\@dashboard\cart\CartSelect\CartTable.jsx", "JavaScript JSX", 7, 0, 0, 0, 0, 7
"c:\Users\21H1 HNQA\Documents\mern_web\restaurants\client\src\section\@dashboard\cart\CartSelect\CartTableItem.jsx", "JavaScript JSX", -1, 0, 0, 0, 2, 1
"c:\Users\21H1 HNQA\Documents\mern_web\restaurants\client\src\section\@dashboard\order\OrderDetail.jsx", "JavaScript JSX", 42, 0, 0, 0, 4, 46
"c:\Users\21H1 HNQA\Documents\mern_web\restaurants\client\src\section\@dashboard\order\OrderInfo.jsx", "JavaScript JSX", 14, 0, 0, 0, 1, 15
"c:\Users\21H1 HNQA\Documents\mern_web\restaurants\client\src\section\@dashboard\order\OrderTab.jsx", "JavaScript JSX", -1, 0, 0, 0, 0, -1
"c:\Users\21H1 HNQA\Documents\mern_web\restaurants\client\src\section\@dashboard\order\OrderTabPanel.jsx", "JavaScript JSX", 16, 0, 0, 1, 2, 19
"c:\Users\21H1 HNQA\Documents\mern_web\restaurants\client\src\section\@dashboard\products\productdetail\ProductInfo.jsx", "JavaScript JSX", 4, 0, 0, 0, 0, 4
"c:\Users\21H1 HNQA\Documents\mern_web\restaurants\client\src\section\@dashboard\setting\Notification.jsx", "JavaScript JSX", 85, 0, 0, 2, 4, 91
"c:\Users\21H1 HNQA\Documents\mern_web\restaurants\client\src\section\@dashboard\setting\UpdatePassword.jsx", "JavaScript JSX", 73, 0, 0, 2, 4, 79
"c:\Users\21H1 HNQA\Documents\mern_web\restaurants\client\src\section\@dashboard\setting\index.jsx", "JavaScript JSX", 2, 0, 0, 0, 1, 3
"c:\Users\21H1 HNQA\Documents\mern_web\restaurants\client\src\section\admin\category\ProductItem.jsx", "JavaScript JSX", 111, 0, 0, 5, 8, 124
"c:\Users\21H1 HNQA\Documents\mern_web\restaurants\client\src\section\admin\category\index.jsx", "JavaScript JSX", 1, 0, 0, 0, 0, 1
"c:\Users\21H1 HNQA\Documents\mern_web\restaurants\client\src\section\admin\order\OrderDetail.jsx", "JavaScript JSX", 208, 0, 0, 3, 7, 218
"c:\Users\21H1 HNQA\Documents\mern_web\restaurants\client\src\section\admin\order\OrderInfo.jsx", "JavaScript JSX", 94, 0, 0, 2, 5, 101
"c:\Users\21H1 HNQA\Documents\mern_web\restaurants\client\src\section\admin\order\OrderTimeLine.jsx", "JavaScript JSX", 110, 0, 0, 2, 3, 115
"c:\Users\21H1 HNQA\Documents\mern_web\restaurants\client\src\section\admin\order\index.jsx", "JavaScript JSX", 2, 0, 0, 0, 0, 2
"c:\Users\21H1 HNQA\Documents\mern_web\restaurants\client\src\section\admin\profile\PreviewAvatar.jsx", "JavaScript JSX", 51, 0, 0, 4, 6, 61
"c:\Users\21H1 HNQA\Documents\mern_web\restaurants\client\src\section\admin\profile\ProfileCardAvatar.jsx", "JavaScript JSX", 72, 0, 0, 35, 4, 111
"c:\Users\21H1 HNQA\Documents\mern_web\restaurants\client\src\section\admin\profile\ProfileCardInfo.jsx", "JavaScript JSX", 132, 0, 0, 3, 8, 143
"c:\Users\21H1 HNQA\Documents\mern_web\restaurants\client\src\section\admin\profile\index.jsx", "JavaScript JSX", 2, 0, 0, 0, 0, 2
"c:\Users\21H1 HNQA\Documents\mern_web\restaurants\client\src\section\admin\setting\Notification.jsx", "JavaScript JSX", 85, 0, 0, 2, 4, 91
"c:\Users\21H1 HNQA\Documents\mern_web\restaurants\client\src\section\admin\setting\UpdatePassword.jsx", "JavaScript JSX", 73, 0, 0, 2, 4, 79
"c:\Users\21H1 HNQA\Documents\mern_web\restaurants\client\src\section\admin\setting\index.jsx", "JavaScript JSX", 2, 0, 0, 0, 1, 3
"c:\Users\21H1 HNQA\Documents\mern_web\restaurants\client\src\section\auth\LoginForm\LoginForm.jsx", "JavaScript JSX", 0, 0, 0, 4, -1, 3
"c:\Users\21H1 HNQA\Documents\mern_web\restaurants\client\src\section\auth\RegisterForm\RegisterForm.jsx", "JavaScript JSX", 0, 0, 0, 2, -1, 1
"c:\Users\21H1 HNQA\Documents\mern_web\restaurants\server\src\app\controllers\CartsController.mjs", "JavaScript", 0, -4, 0, 0, -1, -5
"c:\Users\21H1 HNQA\Documents\mern_web\restaurants\server\src\app\controllers\CategorysController.mjs", "JavaScript", 0, 24, 0, 0, 1, 25
"c:\Users\21H1 HNQA\Documents\mern_web\restaurants\server\src\app\controllers\EmployeesController.mjs", "JavaScript", 0, -1, 0, 0, 0, -1
"c:\Users\21H1 HNQA\Documents\mern_web\restaurants\server\src\app\controllers\OrdersController.mjs", "JavaScript", 0, 12, 0, 0, 1, 13
"c:\Users\21H1 HNQA\Documents\mern_web\restaurants\server\src\app\controllers\ProductsController.mjs", "JavaScript", 0, -1, 0, 0, 0, -1
"c:\Users\21H1 HNQA\Documents\mern_web\restaurants\server\src\app\controllers\UsersController.mjs", "JavaScript", 0, 0, 0, 0, 1, 1
"c:\Users\21H1 HNQA\Documents\mern_web\restaurants\server\src\app\models\Payments.mjs", "JavaScript", 0, -25, 0, 0, -3, -28
"c:\Users\21H1 HNQA\Documents\mern_web\restaurants\server\src\app\models\Users.mjs", "JavaScript", 0, 4, 0, 0, 0, 4
"c:\Users\21H1 HNQA\Documents\mern_web\restaurants\server\src\config\cashbinConfig\cashbinConfig.conf", "Properties", 0, 0, 0, 0, -1, -1
"c:\Users\21H1 HNQA\Documents\mern_web\restaurants\server\src\middleware\cashbinMiddleware.mjs", "JavaScript", 0, -1, 0, 0, 0, -1
"c:\Users\21H1 HNQA\Documents\mern_web\restaurants\server\src\routes\categorysRouter.mjs", "JavaScript", 0, 21, 0, 0, -1, 20
"c:\Users\21H1 HNQA\Documents\mern_web\restaurants\server\src\routes\ordersRouter.mjs", "JavaScript", 0, 1, 0, 0, 0, 1
"Total", "-", 1897, 30, 0, 86, 119, 2132